#!/bin/bash
set -e -f -o pipefail
source "/usr/local/etc/babun.instance"
source "$babun_tools/script.sh"

src="$babun/home/pact"

# if pact not installed
if [ ! -d "$homedir/.pact" ]; then		
	# installing pact
    /bin/cp -rf "$src/.pact" "$homedir/.pact" 
	
ficite 'about-alias'
about-alias 'vagrant aliases'

# Aliases
alias vhl='vagrant hosts list'
alias vscp='vagrant scp'
alias vsl='vagrant snapshot list'
alias vst='vagrant snapshot take'
alias vup="vagrant up"
alias vupl="vagrant up 2>&1 | tee vagrant.log"
alias vh="vagrant halt"
alias vs="vagrant suspend"
alias vr="vagrant resume"
alias vrl="vagrant reload"
alias vssh="vagrant ssh"
alias vst="vagrant status"
alias vp="vagrant provision"
alias vdstr="vagrant destroy"
# requires vagrant-list plugin
alias vl="vagrant list"
# requires vagrant-hostmanager plugin
alias vhst="vagrant hostmanager"
cite 'about-alias'
about-alias 'vault aliases'

# Aliases
alias vad="vault delete"
alias val="vault list"
alias var="vault read"
alias varn="vault renew"
alias varv="vault revoke"
alias vasrv="vault server"
alias vas="vault status"
alias vav="vault version"
alias vaw="vault write"
alias vag="vault login -method=github"
alias varv="vault read -field=value"
