#!/bin/bash
set -e -f -o pipefail
source "/usr/local/etc/babun.instance"
source "$babun_tools/script.sh"

src="$babun_source/babun-dist"
babun_root=/cygdrive/$( cygpath -ma "/" | sed "s/://"g )/..

typeset -i installed_version
installed_version=$(echo "$1" || echo "0") 

# set the cygwin's installed version
if ! [[ -f "$babun/installed/cygwin" ]]; then
	echo -e "1.7.29" > "$babun/installed/cygwin"
fi

# copy dist files to the dist folder
cp -rf "$src/fonts" "$babun_root"
cp -rf "$src/tools" "$babun_root"

# copy start/update scripts
# not overriding start.bat for now -> but possible
# cp -rf "$src/start/start.bat" "$babun_root"
cp -rf "$src/start/update.bat" "$babun_root"
cp -rf "$src/start/rebase.bat" "$babun_root"
cp -rf "$src/start/uninstall.bat" "$babun_root"cite 'about-alias'
about-alias 'osx-specific aliases'

# Desktop Programs
alias fireworks="open -a '/Applications/Adobe Fireworks CS3/Adobe Fireworks CS3.app'"
alias photoshop="open -a '/Applications/Adobe Photoshop CS3/Adobe Photoshop.app'"
alias preview="open -a '$PREVIEW'"
alias xcode="open -a '/Applications/XCode.app'"
alias filemerge="open -a '/Developer/Applications/Utilities/FileMerge.app'"
alias safari="open -a safari"
alias firefox="open -a firefox"
alias chrome="open -a google\ chrome"
alias chromium="open -a chromium"
alias dashcode="open -a dashcode"
alias f='open -a Finder '
alias fh='open -a Finder .'
alias textedit='open -a TextEdit'
alias hex='open -a "Hex Fiend"'
alias skype='open -a Skype'
alias mou='open -a Mou'
alias subl='open -a Sublime\ Text'

if [ -s /usr/bin/firefox ] ; then
  unalias firefox
fi

# Requires growlnotify, which can be found in the Growl DMG under "Extras"
alias grnot='growlnotify -s -t Terminal -m "Done"'

# Get rid of those pesky .DS_Store files recursively
alias dsclean='find . -type f -name .DS_Store -delete'

# Track who is listening to your iTunes music
alias whotunes='lsof -r 2 -n -P -F n -c iTunes -a -i TCP@`hostname`:3689'

# Flush your dns cache
alias flush='dscacheutil -flushcache'

# Show/hide hidden files (for Mac OS X Mavericks)
alias showhidden="defaults write com.apple.finder AppleShowAllFiles TRUE"
alias hidehidden="defaults write com.apple.finder AppleShowAllFiles FALSE"

# From http://apple.stackexchange.com/questions/110343/copy-last-command-in-terminal
alias copyLastCmd='fc -ln -1 | awk '\''{$1=$1}1'\'' ORS='\'''\'' | pbcopy'

# Use Finder's Quick Look on a file (^C or space to close)
alias ql='qlmanage -p 2>/dev/null'

# Mute/Unmute the system volume. Plays nice with all other volume settings.
alias mute="osascript -e 'set volume output muted true'"
alias unmute="osascript -e 'set volume output muted false'"

# Pin to the tail of long commands for an audible alert after long processes
## curl http://downloads.com/hugefile.zip; lmk
alias lmk="say 'Process complete.'"
cite 'about-alias'
about-alias 'phoenix abbreviations'

# Phoenix Commands
alias i='iex'
alias ips='iex -S mix phoenix.server'
alias ism='iex -S mix'
alias m='mix'
alias mab='mix archive.build'
alias mai='mix archive.install'
alias mat='mix app.tree'
alias mc='mix compile'
alias mcv='mix compile --verbose'
alias mcx='mix compile.xref'
alias mdc='mix deps.compile'
alias mdg='mix deps.get'
alias mdgc='mix do deps.get, deps.compile'
alias mdu='mix deps.update'
alias mdt='mix deps.tree'
alias mdua='mix deps.update --all'
alias mdun='mix deps.unlock'
alias mduu='mix deps.unlock --unused'
alias meb='mix escript.build'
alias mec='mix ecto.create'
alias mecm='mix do ecto.create, ecto.migrate'
alias med='mix ecto.drop'
alias mem='mix ecto.migrate'
alias megm='mix ecto.gen.migration'
alias merb='mix ecto.rollback'
alias mers='mix ecto.reset'
alias mho='mix hex.outdated'
alias mlh='mix local.hex'
alias mn='mix new'
alias mns='mix new --sup'
alias mpgc='mix phoenix.gen.channel'
alias mpgh='mix phoenix.gen.html'
alias mpgj='mix phoenix.gen.json'
alias mpgm='mix phoenix.gen.model'
alias mpgs='mix phoenix.gen.secret'
alias mpn='mix phoenix.new'
alias mpr='mix phoenix.routes'
alias mps='mix phoenix.server'
alias mr='mix run'
alias mrnh='mix run --no-halt'
alias mrl='mix release'
alias mt='mix test'
alias mts='mix test --stale'
alias mtw='mix test.watch'
alias mx='mix xref'
