#!/bin/bash
source "/usr/local/etc/babun.instance"
source "$babun_tools/script.sh"
source "$babun_tools/git.sh"cite 'about-alias'
about-alias 'rails abbreviations'

# Rails Commands
alias r='rails'
alias rg='rails g'
alias rs='rails s'
alias rc='rails c'
alias rn='rails new'
alias rb='rails dbconsole'
alias rp='rails plugin'
alias ra='rails application'
alias rd='rails destroy'
alias dbm='rake db:migrate'

alias ss='script/server'
alias ts="thin start"     # thin server
alias sc='script/console'
alias restartapp='touch tmp/restart.txt'
alias restart='touch tmp/restart.txt'  # restart passenger
alias devlog='tail -f log/development.log'
alias taild='tail -f log/development.log' # tail dev log
cite 'about-alias'
about-alias 'common svn abbreviations'

# Aliases
alias svs='svn status'
alias sa='svn add'
alias sci='svn ci -m'
alias sco='svn co'
alias sup='svn up'
alias scu='svn cleanup'
alias sli='svn list'
alias sdel='svn delete'
alias sdif='svn diff'
alias slog='svn log'
alias smv='svn move'
